111111111111111111111
100010C00000000000E01
100010000000001001111
100010000011111000001
111000111001000000001
1P0001C00010000C00001
111111111111111111111
