11111111111111111111
1000100000C0000000E1
10001000000000100001
10001000011111100001
1000000C000100000001
1P000000000100000001
11111111111111111111
