11111111111111111111
1000100C0000000000E1
10001000000000100001
10001000011111100001
10000000000100000001
1P000000000100000001
11111111111111111111
