111111111111111111111
100010C00000000000E01
100010000000001000001
100010000111111000001
100000000001000000001
1P00000C00010000C0001
111111111111111111111
