1111111111111111111111111
1000100000C000000001000E1
1000100000000010000100001
1000100001111110000000001
1000000000010000000000001
1P00000000010000000000001
1111111111111111111111111
