11111111111111111111111111111111111111111
1C000000001000000C0000000001C1100000000E1
100100000C10000000000000000001C0000011111
10010011111111100000000000000010001000001
10100000001C01100000000111111111111111001
1C10000000100000000000000000000C000000001
11111110000000000000001111111111111100001
111C00000000000000C0000000111000000000001
111000000000000001111100001C00000000000C1
11111111100111111C00000000001111111111111
10000000100000000000000000000000000000001
1P10000000000010000000000001C000000000001
11111111111111111111111111111111111111111
