11111111111
1C0010000E1
10001000011
10001000001
11100011001
11100010001
11100011011
1000001C011
100000110C1
10000011001
11100011001
1C00001P001
11111111111
