1111111111111111111111111111
1C001000000000011110000000E1
1000100000000000C10000000111
1000100001111110010000000001
111000110001C000000000000001
1110001000000000000000000001
1110001100000000011111111111
1000001C00000000011111111111
10000011000000000000000010C1
1000001100000000000000001001
1110001100001111110000001001
1P00001C00000001C00000000001
1111111111111111111111111111
