111111111111111111111
100010C0000000000E001
100010000000000111111
100010000111111000001
111000110001000000001
1P00001C00000000C0001
111111111111111111111
