111111111111111111111111111111111111111111111111111
10000000001000000C0000000000001000000000000000000E1
1000000000100000000000000000001000000000C0000011111
100000111111111000000000000000100000000000001000001
100000000010000000000000000000000111111111111111001
10000000001000000000000000000000000000000C000000001
111111100000000000000000000000111111111111111100001
100000000000000000000000000000000000000000000000001
1000000000000000000000000001111100000C0000000000001
111111111111111111111111100000000000011111111111111
100000000000000000000000000000000000000000000000001
1P0000000000000000000000000000000000010000000000001
111111111111111111111111111111111111111111111111111
