11111111111111111111111111111
1E011110011C000000C0100011111
11000000000111010010001100011
110111011C0001000000100C01011
110000000000010010111011000C1
10101101111101001000010101111
1000000000C00111011100001C001
11100111111101000011110111001
10001100C000010100C0000000001
11010001011111000101110100101
1101011101010000000000011C1C1
11010000110101111000100000111
11000000100111000011111100C11
110101100000C000001C000101111
1C010101111111000011011101001
111111000100010C00010C1000001
10000100001101111001011011001
1001100100010000010100001C011
1010100001011011000C111111111
11100111011100010000001110001
101011100010100110011101C0001
10100011011001001100100110101
1000100C000111100100011010111
10C0110111000C0001110000000P1
11111111111111111111111111111
