111111111111111111111111
100010C000000000000000E1
100010000000000000011111
100010000111111000000001
111000111001000000000001
1P00001C00010000000C0001
100000111000000000000001
100000000001000000000001
111111111111111111111111
